MELİKE AKÜZÜM: AFRA EROL, ALAZ EKİCİ
MOHAMED BEN BELKACEM:
ZEYNEP ERDURAN: SUDE CEREN ÖZDEN, NURŞEN EŞAN
SALİH KALAFAT: KIVANÇ KARAHASANOĞLU
SAADET BEGÜM EKMEKÇİ: VEYSEL BAYRAKÇI
OSMAN NURİ ERDOĞAN: SEFER EGE MAHAN
EDA BELGE:
MEHMET EMRE YALÇIN: MUHAMMET VONAL, MOHAMMED SERRAFI
DERYA CEZİK: EDA BELGE
UĞUR KAAN AKYOL: CENGİZ GÜL, UMUT YILMAZ
KIVANÇ KARAHASANOĞLU: MELİK ARDA KONAK
UMUT YILMAZ: SEFER EGE MAHAN
YAĞIZ EFE ERGÜL: SALİH KALAFAT
MUHAMMED EMİR ZENGİN:
AFRA EROL:
MUHAMMET VONAL: BARIŞ BERKAY ŞAHİN, HASAN DALBUDAK
MELİK ARDA KONAK: İLKER CİHAN DURMUŞ, HASAN DALBUDAK
MEHMET CAN AYDIN: ALİ YAĞMUR DEMİREL
VEYSEL BAYRAKÇI: ALAZ EKİCİ, YAĞIZ EFE ERGÜL
NİLHAN TOPÇU: İLHAN GÖKÇE ANAPALI
ŞULE İLKBAHAR: GAMZE DEMİR, PELİNSU ŞAHİN
SEDA YALÇİN: AFRA EROL, ALAZ EKİCİ
ALAZ EKİCİ: KAAN TAMER URKUN
MOHAMMED SERRAFI: ARDA AKDUYGU
NURŞEN EŞAN: EGE GÖKTE ERYÜCEL, DINA NIGUSSE
SEFER EGE MAHAN:
DINA NIGUSSE: DİLARA SÖNMEZ
BİRKAN EGE ÇORBACIOĞLU: BARIŞ BERKAY ŞAHİN, ERHAN YILGIN
PELİNSU ŞAHİN: DİLARA SÖNMEZ
İLHAN GÖKÇE ANAPALI: İLKER CİHAN DURMUŞ
BARIŞ BERKAY ŞAHİN: İLKER CİHAN DURMUŞ
ERHAN YILGIN:   UMUT YILMAZ, DERYA CEZİK
SUDE CEREN ÖZDEN: UMUT YILMAZ
GHAITH BADRIEH: MUHAMMED EMİR ZENGİN, SEFER EGE MAHAN
ALİ YAĞMUR DEMİREL: SEFER EGE MAHAN
SALİH KALAFAT: MOHAMED BEN BELKACEM
KAAN TAMER URKUN:
CENGİZ GÜL: ALAZ EKİCİ, ÖZGÜR CAN YILMAZ
İLKER CİHAN DURMUŞ: HASAN DALBUDAK, KIVANÇ KARAHASANOĞLU
GAMZE DEMİR: NURŞEN EŞAN
UĞUR KAAN AKYOL: CENGİZ GÜL
EGE GÖKTE ERYÜCEL: NURŞEN EŞAN, DİLARA SÖNMEZ
ÖZGÜR CAN YILMAZ: VEYSEL BAYRAKÇI
ABDULKADİR KARATAŞ:VEYSEL BAYRAKÇI
DİLARA SÖNMEZ: SEDA YALÇİN, SUDE CEREN ÖZDEN
HASAN DALBUDAK: DINA NIGUSSE
ARDA AKDUYGU: SUDE CEREN ÖZDEN
YAĞIZ EFE ERGÜL:
